{
  "track": [
    [ 0, 0, 0, 0, 0, 0, 0, 0, 0, 0],
    [ 0, 0, 1, 1, 1, 1, 1, 1, 0, 0],
    [ 0, 1, 1, 1, 1, 1, 1, 1, 1, 0],
    [ 0, 1, 1, 1, 1, 1, 1, 1, 1, 0],
    [ 0, 1, 1, 1, 0, 0, 1, 1, 1, 0],
    [ 0, 1, 1, 1, 0, 0, 1, 1, 1, 0],
	[ 0, 1, 1, 1, 0, 0, 1, 1, 1, 0],
	[ 0, 1, 1, 1, 0, 0, 1, 1, 1, 0],
	[ 0, 1, 1, 1, 0, 0, 1, 1, 1, 0],
	[ 0, 1, 1, 1, 0, 0, 1, 1, 1, 0],
	[ 0, 1, 1, 1, 0, 0, 2, 2, 2, 0],
	[ 0, 1, 1, 1, 0, 0, 1, 1, 1, 0],
	[ 0, 1, 1, 1, 0, 0, 1, 1, 1, 0],
	[ 0, 1, 1, 1, 0, 0, 1, 1, 1, 0],
	[ 0, 1, 1, 1, 0, 0, 1, 1, 1, 0],
	[ 0, 1, 1, 1, 0, 0, 1, 1, 1, 0],
	[ 0, 1, 1, 1, 1, 1, 1, 1, 1, 0],
    [ 0, 1, 1, 1, 1, 1, 1, 1, 1, 0],
	[ 0, 0, 1, 1, 1, 1, 1, 1, 0, 0],
	[ 0, 0, 0, 0, 0, 0, 0, 0, 0, 0]
  ],
  "direction": 1,
  "player": [
    {"active": false, "name": "Player 1", "ai": false, "current": [13,8], "last":[16, 8], "lap": 1},
	{"active": false, "name": "Player 2", "ai": false, "current": [0, 0], "last":[0, 0], "lap": 0},
	{"active": false, "name": "Player 3", "ai": false, "current": [0, 0], "last":[0, 0], "lap": 0},
	{"active": false, "name": "Player 4", "ai": false, "current": [0, 0], "last":[0, 0], "lap": 0}
  ],
  "currentPlayer": 0
}